Purple Rainbow       Alien Tech × Rainbow Belts × Wedding Cake 
Rainbow Cakes        | Noyes Breath × Biscotti × Wedding Cake  
Cake Breath   Wedding Cake × Meatbreath       
 Alienoyes Kush       | Alien Tech × Noyes Kush     
Mangonoyes Kush      | Mango Kush x Noyes Kush 
Citronoyes Haze      | Noyes Haze × Lemon Haze × Noyes Kush
Noyes Haze           | Noyes Kush × Lemon Haze      
Noyes Breath         | Noyes Kush × Meatbreath   
Meat Cakes  | Meatbreath × Wedding Cake   
Biscotti Rocks       | Rainbow Belts × Biscotti × Meatbreath   




Yesno Kush           | Genetic Lottery of 5 Line1 strains            
Shiny Rocks          | Noyes Rocks × Noyes Pebbles   
Noyes Rocks          | Noyes Kush × Biscotti  
Noyes Pebbles        | Citronoyes Haze × Biscotti Rocks          *
Mango Rocks          | Mangonoyes Kush × Biscotti Rocks   
Citrus Pebbles       | Citronoyes Haze × Noyes Pebbles    
Citrus Rocks         | Noyes Kush × Biscotti Rocks       
Alien Rocks          | Alienoyes Kush × Biscotti Rocks               
Citrus Haze Breath   | Citronoyes Haze × Biscotti Rocks × Meatbreath 
 Mango Aliens         | Mangonoyes Kush × Alienoyes Kush           *


 Loud Dreams          | Blue Dream × Noyes Kush        
 Afghani Noyes        | Afghan Kush × Noyes Kush           
White Noyes          | White Widow × Noyes Kush        
Blueberry Fingers    | Noyes Kush × Blueberry Kush      
Cheeto Fingers       | Noyes Kush × Orange Kush     
Noyes OG             | Noyes Kush × OG Kush           
Bubba Noyes          | Noyes Kush × Bubba Kush  
Captain Noyes        | Noyes Kush × Trainwreck          
Hash Fingers         | Noyes Kush × Hash Plant            
Noyes Poison         | Durban Poison × Noyes Kush         


Albino Skunk         | Skunk × ATF × Noyes Breath          
Rainbow Skunk        | Skunk × Rainbow Belts        
Skunk Breath	Skunk × Noyes Breath	
Blueberry Skunk	Skunk × Blueberry Fingers
Skunk Cake	Skunk × Cake Breath	
Le Pew	Skunk × Trainwreck	
Skunk Capone	Skunk × AK47
Skunk Face	Skunk × AK48
Alienized Skunk	Skunk × Alienoyes Kush



Citrus Squirts	ATF × Citronoyes Haze
Noyes Thunder	ATF × Noyes Kush
Snowstorm	ATF × Trainwreck
TFB	ATF × Noyes Breath

trainbreath (noyes breath x trainwreck)
lemon breath (noyes breath x super breath)
larry breath (super larry x super breath)
citrus breath (citrus rocks x noyes breath)
larry noyes (larry og x noyes kush)


super noyes (Noyes kush x super tangie)
super poison (noyes poison x super noyes)
super noyes runts ( animal runtz x super noyes)
super captain noyes (captain noyes x super noyes)
super bubba (super noyes x bubba noyes)
super beath (super noyes x noyes breath)
super alienoyes (alienoyes kush x super noyes)
super rainbow skunk (rainbow skunk x super noyes)
super albino skunk (super noyes x albino skunk)
super larry noyes (larry noyes x super noyes)

